[
    [2,2,2,2,2,2,2,2,2,2,2,2,2,2,2,2,2,2,2,2],
    [2,0,0,0,0,0,0,0,0,0,0,0,0,0,0,0,0,0,0,2],
    [2,0,0,0,0,0,0,0,0,0,0,0,0,0,0,0,0,0,0,2],
    [2,0,0,0,0,0,0,0,0,0,0,0,0,0,0,0,0,0,0,2],
    [2,0,0,0,0,0,0,0,0,0,0,0,0,0,0,0,0,0,0,2],
    [2,0,0,0,0,0,0,0,0,0,0,0,0,0,0,0,0,0,0,2],
    [2,0,0,0,0,0,0,0,0,0,0,0,0,0,0,0,0,0,0,2],
    [2,0,0,0,0,0,0,0,0,0,0,0,0,0,0,0,0,0,0,2],
    [2,0,0,0,0,0,0,0,0,0,0,0,0,0,0,0,0,0,0,2],
    [2,0,0,0,0,0,0,0,0,0,0,0,0,0,0,0,0,0,0,2],
    [2,0,0,0,0,0,0,0,0,0,0,0,0,0,0,0,6,0,5,2],
    [2,0,0,0,0,0,0,0,0,0,0,0,0,0,0,0,0,3,4,2],
    [2,0,0,0,0,0,0,0,0,0,0,0,6,0,0,0,0,0,0,2],
    [2,0,0,0,0,0,0,0,0,0,0,0,0,0,0,0,0,0,0,2],
    [2,0,0,0,0,0,4,0,0,10,0,0,0,11,0,0,0,0,0,2],
    [2,0,0,0,0,4,2,0,0,0,0,0,0,0,0,0,0,0,0,2],
    [2,0,0,0,4,2,2,0,0,0,0,0,0,0,0,0,0,0,0,2],
    [2,0,0,0,2,2,2,0,0,0,0,0,0,0,0,0,0,0,0,2],
    [2,0,0,4,2,2,2,0,0,0,4,4,8,8,8,8,8,8,8,2],
    [2,1,1,1,1,1,1,1,1,1,1,1,1,1,1,1,1,1,1,2]
]